NO ./texter/wall/wall_2.xpm   
SO     ./texter/wall/wall_1.xpm   
EA        ./texter/wall/wall_4.xpm  




WE ./texter/wall/wall_3.xpm


F 250,100,0


C           255,30,11              

1111111111111111111111111111111
1000000000000000001000000000001
1000000000000000000000000000001
10000W0000000000000000000000001
100000001111111D111100000000001
1000000000000000000000000000001
1000000000000000000000000000001
1111111111111111111111111111111


