SO ./texter/wall.xpm
NO ./texter/empty.xpm
WE ./texter/player.xpm
EA ./texter/empty.xpm

F 220,100,0
C 225,30,0



1111111111111111111111111
1000000000110000000000001
1011000001110000000000001
1001000000000000000000001
1111111110110000011100001
1000000000110000011101111
1111011111111101110000011
1111011111111101110101011
1100000011010101110000011
1000000000000000110000011
1000000000N00000110101011
1100000111010101011101111
1111011111110101110111101
1111111111111111111111111
