SO ./texter/wall/1.xpm
NO ./texter/wall/2.xpm
WE ./texter/wall/3.xpm
EA ./texter/wall/4.xpm

F 220,100,0
C 0,30,0


11111111111111111111111111111
1000000000000000000000000001
10000000000000000000000000001
10000W00000000000000000000001
10000000011111111110000000001
10000111111111111111011000001
10000000000000000001000000001
1000011111111D1111110000000001
10000000000000000000000000001
11111111111111111111111111111