SO ./texter/wall/1.xpm
NO ./texter/wall/2.xpm
WE ./texter/wall/3.xpm
EA ./texter/wall/4.xpm
 
F 220,100,0
C 225,30,0



111111111111111111111111111111
    1    1      11    1 1 1
111111111111111111111111111111
100000000000000000000000000001
100000000000000000000000000001
100000000000N00000000000000001
111111111D11000000000000000001
100000000000000001111111000001
100000000000000010000000000001
111100000000000000010100000001
111111111111111111111111111111