SO ./texter/wall.xpm
NO ./texter/empty.xpm
WE ./texter/player.xpm
EA ./texter/empty.xpm

F 220,100,0
C 225,30,0



111111111111111111111111111111
100000000000000000000000000001
1000000N0000000000000000000001
100000000000000000000000000001
111111111011000000000000000001
100000000000000001111111000001
100000000000000010000000000001
111100000000000000010100000001
110000000000000000000000000001
100000000000000000000000000001
100000000000000000000000000001
100000000000000000000000000001
100000000000000000000000000001
111111111111111111111111111111