SO ./texter/wall/1.xpm
NO ./texter/wall/2.xpm
WE ./texter/wall/3.xpm
EA ./texter/wall/4.xpm
 
F 220,100,0
C 225,30,0



11111111111111111111111111111
10000000000000000000000000001
10000000000000000000000000001
10000W00000000000000000000001
10000000111111111110000000001
10000000011        1111111111 
10000000011 
10000000011       11111111111
100000000111111D1110000000001
10000000000000000000000000001
10000000000000000000000000001
10000000000000000000000000001
11111111111111111111111111111