SO ./texter/wall.xpm
NO ./texter/empty.xpm
WE ./texter/player.xpm
EA ./texter/empty.xpm

F 220,100,0
C 225,30,0



1111111111111111111111111
1000000000000000000000001
1000000000000000000000001
1000000000000000000000001
1111111110000000000000001
1000000000000000011111111
1000000000000000100000001
1111000000000000000101001
1100000000000000000000001
1000W00000000000000000001
1000000000000000000000001
1111111111111111111111111
