SO ./texter/wall/wall_1.xpm




NO ./texter/wall/wall_2.xpm
EA        ./texter/wall/wall_4.xpm



WE ./texter/wall/wall_3.xpm

F 220,100,0

C           255,30,111              

111111
100001
100D01
100001
1W00011111
100001
100D011111
100001
100001
111111