NO ./texter/wall/wall_2.xpm
SO ./texter/wall/wall_1.xpm
EA ./texter/wall/wall_4.xpm
WE ./texter/wall/wall_3.xpm

F 255,0,0
C 139,69,19              

111111111111111111111111111111111
100000000000000000000000000000001
10000N000000000000000000000000001
100000001111111D11110000000000001
100000000000000000000000000000001
100000000000000000000000000000001
100000000000000000000000000000001
111111111111111111111111111111111